WWWWWWWWWWWWW  
WGHHHHHHWGHHW  
WJBJBJBJBJXJW  
WJWJBJIIHBBJW  
WJBJHWJIWGBJW  
WJWWXWWYWWZJW  
WJZZWWWWXWXJW  
WJWJHHHHHHBJW  
WJWJWJIIIBXJW  
WJBJBJBJWGXJW  
WIHIHIHIHIHIW  
WJXJXJWJWJWJW  
WWWWWWWWWWWWW  