WXWWWWWWWWWXW
WJHIWJHIWJHIW
WJWJWJWJWJWJW
WJHBJBJBJBJBW
ZJWJWJWJWJWJW
WJHIWJBYJHIYW
WJWJHIYJHIBJW
WBWWJBYJIZXJW
WJXGIHBJBGHWX
WGHBJBWJHZJHW
WJYWJHHIIZJIY
WJHBJWYJIHIXW
WXWWWXWWWWWWY