WWWWWWWWWWWWW  
WGGGGGGGGGGGW  
WGBGBGBGBGBGW  
WGGGBGBGBGGGW  
WGBGBGGGGBGBW  
WGGGBGBGBGGGW  
WGBGGGGGGGBGW  
WGGGBGBGBGGGW  
WGBGBGGGGBGBW  
WGGGBGBGBGGGW  
WGBGBGBGBGBGW  
WGGGGGGGGGGGW  
WWWWWWWWWWWWW 