WXWWWWWWWWWWW  
WGHBGBWGHZGHW  
WJWJIHYJIHWJW  
WJBJBJBJBJBJW  
YJWJHIWJHIWJY  
WJHIYJHIYJHIW  
WJWJHBJBGBJBW  
WBWWJBYGIZXGW  
WJXGIHBJBGHWX  
WJHIWJHIWJIHW  
WJYWGIIIHZJIY  
WJHBJWYJIHIXW  
WXWWWXWWWWWWY