WWWWWWWWWWWWW  
WGGGGGGGGGGGW  
WGBGBGBGBGBGW  
WGBGBGGGGBBGW  
WGBGGGGGGGBGW  
WGBBBBBBBBBGW  
WGBBBBBBBBBGW  
WGBGGGGGGGBGW  
WGBGBGGGGBBGW  
WGBGBGBGBGBGW  
WGGGGGGGGGGGW  
WGBGBGBGBGBGW  
WWWWWWWWWWWWW  