WWWWWWWWWWWWW  
WGGGGGGGGGGGW  
WGBGBGBGBGBGW  
WGBGGGGGGGBGW  
WGBGBGBGBGBGW  
WGGGGBBBBGGGW  
WGGGGBBBBGGGW  
WGBGBGBGBGBGW  
WGBGGGGGGGBGW  
WGBGBGBGBGBGW  
WGGGGGGGGGGGW  
WGBGBGBGBGBGW  
WWWWWWWWWWWWW 