WWWWWWWWWWWWW
WGGGGGGGGGGGW
WGBGBGBGBGBGW
WGGGGGGGGGGGW
WGBGBGBGBGBGW
WGGGGHHHHGGGW
WGGGGHHHHGGGW
WGBGBGBGBGBGW
WGGGGGGGGGGGW
WGBGBGBGBGBGW
WGGGGGGGGGGGW
WGBGBGBGBGBGW
WWWWWWWWWWWWW