WXWWWWWWWWWWW
WGHBWJHIWJHIW
WJWJHIYJHIWJW
WJBJBJBJBJBJW
YJWJWJWJWJWJW
WJHIWJHIYJHBW
WJWJHIYJHIBGW
WBWWJBYJIZXJW
WJXGIHBJBGHWX
WBHBJBWJHZJHW
WJYWJHHXIZJIY
WJHHJWYJIHIXW
WXWWWXWWWWWWY