WWWWWWWWWWWWW
WGBGHHHBGHHHW
WJWJWJZGYJZJW
WJBJHBGIBJHIW
WBWJXJZJYJWBW
WGHIHIIIHIHIW
WBJIIIIIIIBJW
WGWJWJWJZJWJW
WJHIBJHIWIBJW
WJXJXJYJYJWJW
WJHIBJBJHIHIW
WBXJXJYJYJZJW
WWWWWWWWWWWWW