WXWWWWWWWZXWW
WGHHBGHHWGHHW
WJWJWJWJWJWJW
WJBJBJBJBJBJZ
ZJWJWJWJWJWJW
WJHIWJHIWJHIW
WJWJHIYJHIBJW
YJWWJBYJIZXJW
WBXGIHBJBGHWX
WGHBJBWJHZJHW
WJYWJHHIIZJIY
WJHBJWYJIHIXW
WXWWWXWWWWWWY
